000000000000000
000000111111100
000000100041100
000111100001100
000140000004100
000111100300100
000000100101100
000000104101100
000004111101100
000000000001100
000000000111100
020011110100000
010410014100000
011110011100000
000000000000000
000000000000000
000000000000000
000000000000000
000000000000000
000000000000000
