000000000000000
000000000000000
003002111000000
001000001000000
001000001000000
001111101000000
001000401000000
001000001000000
041040001000000
001000001000000
001111111000000
000000000000000
000000000000000
000000000000000
000000000000000
000000000000000
000000000000000
000000000000000
000000000000000
000000000000000
