000000000000000
000000111111000
000000100041000
000111100001000
000140000001110
000111100300410
000000100101110
000000104101000
000004111101000
000000000001000
000000000111000
020011110100000
010410014100000
011110011100000
000000000000000
000000000000000
000000000000000
000000000000000
000000000000000
000000000000000
